q,Q, , ,2,1,L4,10
w,W, , ,2,2,L3,4
e,E, , ,2,3,L2,3
r,R, , ,2,4,L1,2
t,T, , ,2,5,L1,3
y,Y, , ,2,6,R1,3
u,U, , ,2,7,R1,2
i,I, , ,2,8,R2,2
o,O, , ,2,9,R3,4
p,P, , ,2,10,R4,8
a,A, , ,3,1,L4,3
s,S, , ,3,2,L3,2
d,D, , ,3,3,L2,1
f,F, , ,3,4,L1,1
g,G, , ,3,5,L1,2
h,H, , ,3,6,R1,2
j,J, , ,3,7,R1,1
k,K, , ,3,8,R2,1
l,L, , ,3,9,R3,2
;,:, , ,3,10,R4,3
z,Z, , ,4,1,L4,6
x,X, , ,4,2,L3,9
c,C, , ,4,3,L1,3
v,V, , ,4,4,L1,2
b,B, , ,4,5,R1,3
n,N, , ,4,6,R2,1
m,M, , ,4,7,R3,2
, , , ,4,8,R4,1
. , , , ,4,9,R4,1